************
*          *
*          *
*        * *
*        * *
*        * *
*     **** *
*     * G* *
*     *  * *
*     *  * *
*          *
************
